R 1920 1080
NO ./textures/1.xpm
SO ./textures/1.xpm
WE ./textures/1.xpm
EA ./textures/2.xpm
S ./textures/marvin.xpm

F 0,0,0
C 0,0,0

         11111111111111111111111111111111111111111111111111111111111111111111111111111111111111111111111111111111111111111111111111111111111111111111111111111111111111111111111111111111111111111111111111111111111111111111111111111111111111111111111111111111111111111111111111
        1000000000110000000000000000000000000000000000000000000000000000000000000000000000000020000000000000002000000000000000000000000000000000000000000000000000000000000000020000000000000002000000000000000000000000000000000000000000000000000000000000000020000000000000002001
        101100000E110000002000000000000000000200000000000000000020000000000000000000000000000000000000000000000000000000000000200000000000000000020000000000000000000000000000000000000000000000000000000000000200000000000000000020000000000000000000000000000000000000000000000001
        1001000000000000000000000000000000000000000000000000000000000000000000000002000000000000000000000000200000000000000000000000000000000000000000000000000000002000000000000000000000000200000000000000000000000000000000000000000000000000000002000000000000000000000000200001
 11111111011000001110000000000000000000000000000000000000000000000000000000000000000000000000000200000000000000000000000000000000000000000000000000000000000000000000000000000000200000000000000000000000000000000000000000000000000000000000000000000000000000000200000000000000001
10000000001100000111011111111111111111111111111111111111111111111111111111111111111111111111111111111111111111111111111111111111111111111111111111111111111111111111111111111111111111111111111111111111111111111111111111111111111111111111111111111111111111111111111111111111111
11110111111111011100000000021
11110111111111011101012020001
11000000110101011100000020001
10002000000000001100000020001
1000000000000000110101000001
11000001110101011111011000111
11110111 1110101 101111010001
 1111111 1111111 11111111111